########################################
#####**********************************#
###************************************#
###************************************#
#**************************************#
#**************************************#
#***********###############************#
#************#***********#*************#
#************#***********#*************#
#************#***********#*************#
#************#***********#*************#
#************#***********#*************#
#************#***********#*************#
#************#*************************#
#************#*************************#
#************#*************************#
############################***********#
#************#*************************#
#************#*************************#
#************#*************************#
#************#*************************#
#**************************************#
#**************************************#
#*******************############*******#
#********************#*****************#
#********************#*****************#
#********************#*****************#
#********************#*****************#
#######################****************#
#**************************************#
#**************************************#
#**************************************#
#**************************************#
#*****************###########**********#
#********************#*****************#
#********************#*****************#
#********************#*****************#
#********************#*****************#
#********************#*****************#
########################################