########################################
#**************************************#
#**************************************#
#**************************************#
#**************************************#
#**************************************#
#***********############***************#
#************#*************************#
#************#*************************#
#************#*************************#
#************#*************************#
#************#*************************#
#************#*************************#
#************#*************************#
#************#*************************#
#************#*************************#
#****###########***********************#
#**************************************#
#**************************************#
#**************************************#
#**************************************#
#**************************************#
#**************************************#
#*******************############*******#
#********************#*****************#
#********************#*****************#
#********************#*****************#
#********************#*****************#
#*******###############****************#
#**************************************#
#**************************************#
#**************************************#
#**************************************#
#*****************###########**********#
#********************#*****************#
#********************#*****************#
#********************#*****************#
#********************#*****************#
#********************#*****************#
########################################